Pop	Color
GBR	white
FIN	aliceblue
CHS	antiquewhite
PUR	antiquewhite1
CDX	antiquewhite2
CLM	antiquewhite3
IBS	antiquewhite4
PEL	aquamarine
PJL	aquamarine1
KHV	aquamarine2
ACB	aquamarine3
GWD	aquamarine4
ESN	azure
BEB	azure1
MSL	azure2
STU	azure3
ITU	azure4
CEU	beige
YRI	bisque
CHB	bisque1
JPT	bisque2
LWK	bisque3
ASW	bisque4
MXL	black
TSI	blanchedalmond
GIH	blue
